22 0 0 0 1 16 2 0 0 0 0 0 0 0 0 0
22 0 0 0 1 16 2 0 0 0 0 0 0 0 0 0
22 0 0 0 1 16 2 0 0 0 0 0 0 0 0 0
22 0 0 0 1 16 10 3 3 3 3 3 3 3 3 3
22 0 0 0 1 16 16 16 16 16 16 16 16 16 16 16
22 0 0 0 1 16 12 4 4 4 4 4 4 4 4 4
22 0 0 0 1 16 2 0 0 0 0 0 0 0 0 0
22 0 0 0 1 16 2 0 0 0 0 0 0 0 0 0
22 0 0 0 1 16 2 0 0 0 0 0 0 0 0 0