0 0 0 0 0 0 1 16 16 2 0 0 0 0 0 0
0 0 0 0 0 0 1 16 16 2 0 0 0 0 0 0
3 3 3 3 3 3 9 16 16 10 3 3 3 3 3 3
16 16 16 16 16 16 16 16 16 16 16 16 16 16 16 16
4 4 4 4 4 4 4 4 4 4 4 4 4 4 4 4
0 0 0 0 0 0 0 0 0 0 0 0 0 0 0 0
0 0 0 0 0 0 0 0 0 0 0 0 0 0 0 0
0 0 0 0 0 0 0 0 0 0 0 0 0 0 0 0
18 18 18 18 18 18 18 18 18 18 18 18 18 18 18 18