0 0 0 0 0 0 1 16 16 2 0 0 0 0 0 0
0 0 0 0 0 0 1 16 16 2 0 0 0 0 0 0
0 0 0 7 3 3 9 16 16 10 3 3 8 0 0 0
3 3 3 9 13 14 15 13 14 15 13 14 10 3 3 3
16 16 16 16 14 15 13 14 15 13 14 15 16 16 16 16
4 4 4 11 15 13 14 15 13 14 15 13 12 4 4 4
0 0 0 5 4 4 11 16 16 12 4 4 6 0 0 0
0 0 0 0 0 0 1 16 16 2 0 0 0 0 0 0
0 0 0 0 0 0 1 16 16 2 0 0 0 0 0 0