23 23 23 23 23 23 23 23 23 23 23 23 23 23 23 23
0 0 0 0 0 0 0 0 0 0 0 0 0 0 0 0
0 0 0 0 0 0 0 0 0 0 0 0 0 0 0 0
3 3 3 3 3 3 3 3 3 3 3 3 3 3 3 3
16 16 16 16 16 16 16 16 16 16 16 16 16 16 16 16
4 4 4 4 4 4 11 16 16 12 4 4 4 4 4 4
0 0 0 0 0 0 1 16 16 2 0 0 0 0 0 0
0 0 0 0 0 0 1 16 16 2 0 0 0 0 0 0
0 0 0 0 0 0 1 16 16 2 0 0 0 0 0 0