0 0 0 0 0 0 0 0 0 1 16 2 0 0 0 20
0 0 0 0 0 0 0 0 0 1 16 2 0 0 0 20
0 0 0 0 0 0 0 0 0 1 16 2 0 0 0 20
3 3 3 3 3 3 3 3 3 9 16 2 0 0 0 20
16 16 16 16 16 16 16 16 16 16 16 2 0 0 0 20
4 4 4 4 4 4 4 4 4 4 4 6 0 0 0 20
0 0 0 0 0 0 0 0 0 0 0 0 0 0 0 20
0 0 0 0 0 0 0 0 0 0 0 0 0 0 0 20
18 18 18 18 18 18 18 18 18 18 18 18 18 18 18 27 