23 23 23 23 23 23 23 23 23 23 23 23 23 23 23 25
0 0 0 0 0 0 0 0 0 0 0 0 0 0 0 20
0 0 0 0 0 0 0 0 0 0 0 0 0 0 0 20
3 3 3 3 3 3 3 3 3 3 3 8 0 0 0 20
16 16 16 16 16 16 16 16 16 16 16 2 0 0 0 20
4 4 4 4 4 4 4 4 4 11 16 2 0 0 0 20
0 0 0 0 0 0 0 0 0 1 16 2 0 0 0 20
0 0 0 0 0 0 0 0 0 1 16 2 0 0 0 20
0 0 0 0 0 0 0 0 0 1 16 2 0 0 0 20